0, 0
1000
1, 1, 0, 1, 3, 1, 4, 1, 1, 1, 1, 1, 1, 6, 1, 1, 1, 1, 1, 1
1, 1, 1, 2, 1, 1, 1, 1, 1, 1, 2, 1, 1, 1, 1, 1, 1, 1, 1, 1
1, 4, 1, 1, 9, 1, 1, 3, 1, 1, 1, 1, 1, 1, 2, 1, 1, 1, 1, 1
5, 1, 1, 1, 5, 1, 1, 1, 1, 1, 1, 4, 1, 7, 1, 1, 1, 2, 9, 1
1, 1, 1, 1, 0, 7, 1, 1, 1, 1, 1, 1, 1, 1, 1, 1, 1, 1, 1, 0
1, 1, 8, 9, 3, 1, 1, 1, 1, 5, 1, 1, 1, 1, 1, 1, 1, 1, 1, 1
1, 1, 1, 1, 2, 1, 1, 1, 5, 1, 1, 4, 2, 1, 1, 1, 1, 1, 1, 1
1, 1, 1, 1, 1, 1, 1, 1, 1, 1, 7, 1, 1, 7, 1, 1, 1, 0, 1, 1
1, 1, 1, 1, 1, 1, 1, 1, 1, 1, 1, 1, 1, 2, 1, 7, 1, 1, 5, 1
1, 7, 8, 1, 1, 1, 1, 1, 1, 1, 1, 9, 0, 1, 4, 1, 1, 1, 1, 1
1, 1, 1, 3, 1, 1, 1, 1, 3, 1, 1, 1, 1, 1, 1, 1, 1, 1, 1, 1
1, 1, 1, 1, 1, 1, 1, 1, 1, 9, 9, 1, 1, 1, 1, 7, 1, 1, 1, 1
1, 1, 1, 1, 1, 7, 1, 6, 1, 1, 1, 1, 1, 7, 1, 2, 0, 1, 6, 1
1, 1, 1, 1, 1, 1, 1, 1, 1, 1, 1, 9, 6, 0, 1, 1, 1, 1, 1, 1
1, 1, 1, 1, 1, 1, 1, 1, 1, 1, 1, 1, 1, 1, 1, 1, 1, 1, 3, 1
1, 3, 1, 5, 1, 1, 1, 1, 1, 1, 1, 8, 1, 1, 1, 1, 1, 2, 1, 1
1, 1, 6, 1, 3, 1, 6, 1, 6, 1, 1, 1, 1, 1, 1, 9, 9, 1, 1, 1
1, 1, 1, 1, 1, 1, 1, 1, 1, 1, 3, 1, 1, 1, 1, 1, 1, 1, 1, 1
1, 1, 1, 1, 1, 1, 1, 1, 1, 1, 1, 1, 1, 4, 1, 1, 1, 1, 1, 1
5, 1, 1, 1, 1, 1, 1, 1, 8, 1, 1, 1, 1, 1, 3, 1, 1, 8, 1, 1
3, 1, 1, 1, 1, 1, 1, 1, 1, 1, 1, 1, 1, 1, 1, 1, 1, 1, 1, 1
1, 1, 1, 2, 3, 1, 1, 1, 8, 1, 1, 6, 1, 1, 7, 3, 1, 1, 3, 1
1, 1, 1, 1, 1, 1, 1, 1, 1, 1, 1, 1, 1, 1, 1, 1, 1, 1, 1, 1
1, 1, 1, 1, 1, 1, 1, 7, 1, 1, 6, 1, 1, 1, 1, 1, 1, 1, 1, 1
1, 1, 1, 1, 1, 1, 1, 7, 1, 3, 9, 8, 1, 1, 5, 1, 6, 2, 1, 1
1, 1, 1, 5, 0, 1, 1, 1, 1, 1, 1, 1, 1, 1, 1, 1, 1, 1, 6, 1
1, 1, 1, 1, 9, 1, 8, 1, 1, 5, 1, 1, 6, 1, 1, 1, 0, 1, 1, 1
6, 1, 1, 1, 1, 1, 1, 7, 9, 1, 1, 1, 9, 1, 1, 1, 5, 1, 1, 1
1, 1, 1, 8, 4, 1, 1, 1, 1, 1, 1, 7, 1, 1, 4, 1, 8, 1, 1, 9
1, 1, 7, 1, 1, 1, 1, 1, 1, 1, 1, 1, 1, 1, 1, 1, 1, 1, 1, 1
1, 1, 1, 2, 1, 5, 1, 1, 2, 1, 1, 1, 1, 1, 1, 0, 1, 1, 1, 1
3, 9, 1, 4, 1, 1, 1, 1, 8, 4, 1, 1, 1, 2, 1, 1, 1, 8, 2, 1
1, 1, 1, 1, 1, 1, 2, 1, 1, 1, 1, 4, 0, 1, 7, 1, 1, 1, 1, 1
2, 1, 1, 5, 1, 1, 1, 1, 1, 1, 1, 9, 0, 0, 4, 1, 1, 6, 1, 0
4, 9, 1, 1, 1, 1, 1, 5, 1, 1, 8, 1, 1, 1, 1, 9, 1, 1, 1, 1
1, 1, 1, 5, 1, 1, 0, 1, 1, 1, 1, 1, 6, 1, 1, 3, 1, 1, 1, 1
1, 1, 3, 1, 1, 1, 1, 1, 1, 0, 1, 1, 1, 1, 2, 1, 1, 1, 1, 1
7, 1, 3, 1, 1, 1, 1, 1, 1, 1, 1, 2, 8, 1, 1, 1, 1, 1, 1, 1
1, 9, 1, 1, 1, 3, 1, 1, 0, 1, 1, 1, 9, 1, 1, 1, 1, 1, 1, 1
1, 1, 1, 1, 1, 3, 4, 1, 1, 1, 1, 2, 3, 1, 1, 0, 1, 1, 3, 1
1, 9, 1, 1, 1, 1, 1, 1, 1, 1, 1, 1, 1, 1, 1, 8, 1, 2, 4, 1
1, 1, 1, 1, 0, 1, 8, 1, 1, 1, 1, 1, 1, 1, 1, 7, 1, 1, 1, 1
1, 1, 1, 1, 5, 1, 1, 1, 1, 1, 1, 1, 1, 8, 1, 1, 7, 1, 6, 1
1, 1, 1, 1, 1, 1, 1, 1, 1, 1, 1, 1, 1, 1, 1, 1, 1, 3, 1, 1
1, 1, 1, 1, 1, 1, 1, 4, 1, 1, 0, 1, 1, 6, 5, 1, 1, 5, 1, 1
1, 1, 1, 1, 1, 1, 1, 5, 1, 1, 1, 6, 9, 1, 1, 1, 1, 1, 1, 5
1, 1, 1, 8, 1, 1, 4, 1, 1, 1, 1, 1, 1, 1, 1, 1, 3, 1, 1, 1
1, 1, 4, 1, 1, 1, 2, 1, 1, 1, 1, 1, 1, 9, 5, 1, 5, 6, 5, 1
1, 1, 1, 3, 5, 1, 1, 9, 3, 1, 1, 9, 1, 1, 1, 1, 1, 1, 8, 1
1, 1, 1, 1, 1, 1, 1, 3, 9, 9, 1, 1, 1, 1, 1, 1, 1, 1, 1, 1
